[size]
width=8
height=5

[horizontal walls]
11;11;11;11;11;11;11;11
11;0;11;11;11;11;0;11
11;0;11;11;11;11;0;11
11;11;11;0;11;11;11;11
11;11;11;0;11;11;11;11
11;11;11;11;11;11;11;11

[vertical walls]
11;0;0;0;0;0;0;0;11
11;0;0;0;0;0;0;0;11
11;0;0;11;0;0;0;0;11
11;0;0;0;0;0;0;0;11
11;0;0;0;0;0;0;0;11

[stairs]
0;11;0;0;0;0;11;0
0;11;0;0;0;0;11;0
0;0;0;11;0;0;0;0
0;0;0;11;0;0;0;0
0;0;0;0;0;0;0;0

[firemen]
1

[fires]
3
2;2
7;3
0;4

