[size]
width=8
height=6

[horizontal walls]
11;11;11;11;11;11;11;11
11;11;11;11;0;11;11;0
11;11;11;11;0;0;0;0
11;11;11;11;0;11;11;0
11;11;11;11;0;0;0;0
11;11;11;11;0;11;11;0
11;11;11;11;11;11;11;11

[vertical walls]
11;0;0;0;0;0;0;0;11
11;0;0;0;0;11;0;0;11
11;0;0;0;0;0;0;0;11
11;0;0;0;0;0;0;11;11
11;0;0;0;0;0;0;0;11
11;0;0;0;0;0;0;0;11

[stairs]
0;0;0;0;11;0;0;0
0;0;0;0;11;0;0;0
0;0;0;0;11;0;0;11
0;0;0;0;11;0;0;11
0;0;0;0;0;0;0;11
0;0;0;0;0;0;0;0

[firemen]
2

[fires]
4
0;1
2;3
0;5
6;1
