[size]
width=10
height=6

[horizontal walls]
11;11;11;11;11;11;11;11;11;11
11;0;11;11;11;11;11;11;11;0
11;0;11;11;11;11;11;11;11;0
0;0;11;11;11;0;11;11;11;0
0;0;11;11;0;0;11;11;11;0
11;0;11;11;11;11;11;11;11;0
11;11;11;11;11;11;11;11;11;11

[vertical walls]
11;0;0;0;0;11;0;0;0;0;11
11;0;0;0;0;11;0;0;0;0;11
11;0;0;0;0;11;0;0;0;0;11
11;0;0;0;0;11;11;0;0;0;11
11;0;11;0;0;11;0;0;0;0;11
11;0;0;0;0;0;0;0;0;0;11

[stairs]
0;11;0;0;0;0;0;0;0;11
0;11;0;0;0;0;0;0;0;11
0;11;0;0;0;0;0;0;0;11
0;11;0;0;11;0;0;0;0;11
0;11;0;0;0;0;0;0;0;11
0;0;0;0;0;0;0;0;0;0

[firemen]
3

[bombs]
2
2;4
5;1

[fires]
6
7;3
3;1
3;4
4;2
6;1
7;2