[size]
width=10
height=6

[horizontal walls]
11;11;11;11;11;11;11;11;11;11
11;11;11;0;11;11;0;11;11;11
11;11;11;0;11;11;0;11;11;11
11;11;11;0;11;11;0;11;11;11
11;11;11;0;11;11;0;11;11;11
11;11;11;0;11;11;0;11;11;11
11;11;11;11;11;11;11;11;11;11

[vertical walls]
11;0;0;0;0;11;0;0;0;0;11
11;0;0;0;0;0;0;0;0;0;11
11;0;0;0;0;11;0;0;0;0;11
11;0;0;0;0;11;0;0;0;0;11
11;0;0;0;0;11;0;0;0;0;11
11;0;0;0;0;11;0;0;0;0;11

[stairs]
0;0;0;11;0;0;11;0;0;0
0;0;0;11;0;0;11;0;0;0
0;0;0;11;0;0;11;0;0;0
0;0;0;11;0;0;11;0;0;0
0;0;0;11;0;0;11;0;0;0
0;0;0;0;0;0;0;0;0;0

[firemen]
4

[comps]
6
0;1
0;3
0;5
9;1
9;3
9;5
5;0

[fires]
9
4;2
6;2
1;1
2;3
2;5
5;1
7;1
7;3
7;5
