[size]
width=8
height=10

[horizontal walls]
11;11;11;11;11;11;11;11
0;11;11;11;11;11;11;0
0;0;0;0;0;0;0;0
0;0;0;11;11;11;11;0
0;11;11;11;11;11;11;0
11;11;0;11;11;0;11;11
11;11;0;11;11;0;11;11
11;11;0;11;11;0;11;11
0;11;0;11;11;0;11;11
0;11;11;11;11;11;11;11
11;11;11;11;11;11;11;11

[vertical walls]
11;0;0;0;0;0;0;0;11
11;0;11;0;0;0;0;11;11
11;0;11;0;0;0;0;11;11
11;0;11;0;0;0;0;0;11
11;0;0;0;0;0;0;0;11
11;0;0;0;0;0;0;0;11
11;0;0;0;11;0;0;0;11
11;0;0;0;11;0;0;0;11
11;0;0;0;11;0;0;0;11
11;0;0;0;0;0;0;0;11

[stairs]
11;0;0;0;0;0;0;11
11;0;11;0;0;0;0;11
11;0;11;0;0;0;0;11
11;0;0;0;0;0;0;11
0;0;11;0;0;11;0;0
0;0;11;0;0;11;0;0
0;0;11;0;0;11;0;0
0;0;11;0;0;11;0;0
11;0;0;0;0;0;0;0
0;0;0;0;0;0;0;0

[firemen]
4

[vip]
vip_x=6
vip_y=9

[comps]
8
0;5
0;6
0;7
7;5
7;6
7;7
7;8
7;9
6;2

[fires]
6
5;1
1;3
2;4
2;7
5;7
7;3