[size]
width=8
height=12

[horizontal walls]
11;11;11;11;11;11;11;11
11;11;11;0;11;11;11;11
11;11;11;0;11;11;11;11
11;11;11;0;11;11;11;11
0;0;0;0;0;0;0;0
11;11;11;0;11;11;11;11
0;0;0;0;0;0;0;0
11;11;11;0;11;11;11;11
0;0;0;0;0;0;0;0
11;11;11;0;11;11;11;11
0;0;0;0;0;0;0;0
11;11;11;0;11;11;11;11
11;11;11;11;11;11;11;11

[vertical walls]
11;0;0;0;0;0;0;0;11
11;0;0;0;0;0;0;0;11
11;0;0;0;0;0;0;0;11
11;0;0;0;0;0;0;0;11
11;0;0;0;0;0;0;0;11
11;0;0;0;0;0;0;0;11
11;0;0;0;0;0;0;0;11
11;0;0;0;0;0;0;0;11
11;0;0;0;0;0;0;0;11
11;0;0;0;0;0;0;0;11
11;0;0;0;0;0;0;0;11
11;0;0;0;0;0;0;0;11

[stairs]
0;0;0;11;0;0;0;0
0;0;0;11;0;0;0;0
0;0;0;11;0;0;0;0
0;0;0;11;0;0;0;0
0;0;0;11;0;0;0;0
0;0;0;11;0;0;0;0
0;0;0;11;0;0;0;0
0;0;0;11;0;0;0;0
0;0;0;11;0;0;0;0
0;0;0;11;0;0;0;0
0;0;0;11;0;0;0;0
0;0;0;0;0;0;0;0

[firemen]
5

[comps]
16
0;1
0;3
0;5
0;7
0;9
1;9
0;11
1;11
7;1
7;3
7;5
7;7
7;9
6;9
7;11
6;11
7;2

[fires]
10
2;1
5;1
1;2
6;2
2;5
5;5
2;7
5;9
2;11
5;11