[size]
width=10
height=12

[horizontal walls]
11;11;11;11;11;11;11;11;11;11
11;0;11;11;11;11;11;11;0;11
11;0;11;0;11;11;11;11;0;11
11;11;11;0;11;11;11;11;11;11
0;0;0;0;11;11;11;11;11;11
11;11;11;0;0;0;0;11;11;11
0;0;0;0;11;11;0;0;0;0
11;11;11;0;0;0;0;11;11;11
11;11;11;0;11;11;0;0;0;0
11;11;11;11;11;11;0;11;11;11
11;0;11;11;11;11;11;11;0;11
11;0;11;0;11;11;11;11;0;11
11;11;11;11;11;11;11;11;11;11


[vertical walls]
11;0;0;0;0;0;0;0;0;0;11
11;0;0;0;0;0;0;0;0;0;11
11;0;0;0;0;0;0;0;0;0;11
11;0;0;0;0;0;0;0;0;0;11
11;0;0;0;0;0;0;0;0;0;11
11;0;11;0;0;0;0;0;11;0;11
11;0;0;0;0;0;0;0;0;0;11
11;0;0;0;0;0;0;0;11;0;11
11;0;0;0;0;0;0;0;0;0;11
11;0;0;0;0;0;0;0;0;0;11
11;0;11;0;0;0;0;0;0;0;11
11;0;11;0;0;0;0;0;11;0;11

[stairs]
0;11;0;0;0;0;0;0;11;0
0;11;0;0;0;0;0;0;11;0
0;0;0;11;0;0;0;0;0;0
0;0;0;11;0;0;0;0;0;0
0;0;0;11;0;0;11;0;0;0
0;0;0;11;0;0;11;0;0;0
0;0;0;11;0;0;11;0;0;0
0;0;0;11;0;0;11;0;0;0
0;0;0;0;0;0;11;0;0;0
0;11;0;0;0;0;0;0;11;0
0;11;0;0;0;0;0;0;11;0
0;11;0;0;0;0;0;0;11;0

[firemen]
6

[comps]
15
0;2
0;5
0;7
0;9
0;10
0;11
9;1
9;5
9;7
9;9
9;10
9;11
5;3
5;8
7;3
9;3

[bombs]
5
1;5
2;11
7;11
8;7
8;9

[fires]
10
2;1
2;3
2;7
3;8
2;9
8;2
7;4
7;6
7;8
5;10