[size]
width=10
height=10

[horizontal walls]
11;11;11;11;11;11;11;11;11;11
11;11;11;0;0;0;0;11;11;11
0;0;0;0;11;11;0;0;0;0
11;11;11;0;11;11;0;11;11;11
11;11;11;0;11;11;0;11;11;11
0;11;0;11;11;11;11;0;0;0
11;0;0;0;0;0;0;0;0;11
11;11;0;0;11;11;11;0;11;11
0;11;11;0;0;0;0;0;0;0
0;11;0;11;0;11;11;11;0;11
11;11;11;11;11;11;11;11;11;11


[vertical walls]
11;0;0;0;0;0;0;0;0;0;11
11;0;0;0;0;0;0;0;0;0;11
11;0;0;0;0;0;0;0;0;0;11
11;0;0;0;0;0;0;0;0;0;11
11;0;0;0;0;0;0;0;0;0;11
11;0;11;0;0;0;0;0;0;0;11
11;0;11;0;0;0;0;11;0;0;11
11;0;0;0;11;0;0;0;0;0;11
11;0;0;0;11;0;0;0;0;0;11
11;11;0;0;11;0;0;0;0;0;11

[stairs]
0;0;0;11;0;0;11;0;0;0
0;0;0;11;0;0;11;0;0;0
0;0;0;11;0;0;11;0;0;0
0;0;0;11;0;0;11;0;0;0
0;0;11;0;0;0;0;11;0;0
0;0;11;0;0;0;0;11;0;0
0;0;11;0;0;0;0;11;0;0
11;0;0;0;11;0;0;0;11;0
0;0;11;0;11;0;0;0;11;0
0;0;0;0;11;0;0;0;0;0

[firemen]
5

[vip]
vip_x=6
vip_y=9

[comps]
7
0;3
5;5
3;9
5;3
6;7
1;4
9;4
1;8

[bombs]
2
0;6
5;9

[fires]
10
3;5
6;4
5;7
0;1
2;1
2;3
8;1
9;3
1;5
1;9
9;9